0000000000000000000
0211111110000000000
0000000010000000000
0111000011111111110
0100010101000010000
0100010101111111110
0111010100000101010
0001010111111101010
0001010000100001010
0001111110100001000
0001010101000011110
0101010101000000000
0101010101011111110
0111010101010000010
0100011101110111010
0100000000100001010
0111111000100011110
0100001000100010000
0111111111110011130
0000000000000000000
